NO ./textures/wall/wall_1.xpm
SO ./textures/wall/wall_2.xpm
WE ./textures/wall/wall_3.xpm
EA ./textures/wall/wood.xpm             

F 120,75,208
C 60,200,225

      11111111    111111111111111
     110000001    100000000000001
    1100200011    100011100000001
   1100000011     10011 100002001
  1100000011      1011  100000001
 1100000011       111  1100000011
110002000111111       1100002011
100000000000001      1100000011
100000000002001     1100200011
111111110000001    1100000011  11
       10000001   1000000N11  101
       10000001111100000001111101        
       10000000000000000000000001
       11111111111111111111111111
