NO ./textures/wall/wall_1.xpm
SO ./textures/wall/wall_2.xpm
WE ./textures/wall/wall_3.xpm
EA ./textures/wall/wood.xpm             
S ./textures/sprites/mush.xpm

F 120,75,5
C 60,200,225

       1111111     111111111111111
      10000001     100000000000001
     10000001      100011100020001
    10000001       1001  100000001
   10000001        101   100000001
  10000001         11    100020001
 10000001111111         100000001
100000000000001        100000001
100000000000001       100020001
111111110000001      100000001  11
       10000001     1000000N1  101
       100000011111100000001111001        
       100000000000000000000000001
       111111111111111111111111111
