NO ./textures/wall/wall_1.xpm
SO ./textures/wall/wall_2.xpm
WE ./textures/wall/wall_3.xpm
EA ./textures/wall/wood.xpm             
S ./textures/sprites/mush.xpm

F 120,75,5
C 60,200,225

      11111111     111111111111111
     110000001     100000000000001
    1100000011     100011100020001
   1100000011      1001  100000001
  1100000011       101   100000001
 1100000011        11   1100020001
110000001111111        11000000011
100000000000001       11000000011
100000000000001      11000200011
111111110000001     11000000011 11
       10000001    11000000N11 101
       100000011111100000001111101        
       100000000000000000000000001
       111111111111111111111111111