R 12000 9000
NO ./textures/wall/wood.xpm
SO ./textures/wall/wall_4.xpm
WE ./textures/wall/wall_2.xpm
EA ./textures/wall/wall_b.xpm             
S textures/sprites/
F 255,60,5
C 35,255,5


      111111111    1111111111111111
     1100000011    1000000000000001
    1100000011     1000111000200001
   1100000011      10011 1000200001
  1100000011       1011  1000200001
 1100000011        111   1000200001
110000001111111         1000200011
100000000000001        1000200011
1000N0000000001       1000200011
111111110000001      1000200011 111
       10000001     1000200011 1101
       1000000111111000000011111001        
       1000000000000000000000000001
       1111111111111111111111111111
