R 45900 96600
NO textures/wall/wall_b.xpm
SO textures/wall/wall_b.xpm
WE textures/wall/wall_b.xpm
EA textures/wall/wall_b.xpm             
S textures/sprites/
F 29,186,220
C 120,60,5


      111111111    1111111111111111
     1100000011    1000000000000001
    1100000011     1000111000200001
   1100000011      10011 1000200001
  1100000011       1011  1000200001
 1100000011        111   1000200001
110000001111111        11000200011
100000000000001       11000200011
1000E0000000001      11000200011
111111110000001     11000200011 111
       10000001    11000200011 1101
       1000000111111000000011111001        
       1000000000000000000000000001
       1111111111111111111111111111
