NO ./textures/wall/wood.xpm
SO ./textures/wall/grasswall.xpm
WE ./textures/wall/satan.xpm
EA ./textures/wall/satan.xpm             
S textures/sprites/
F 255,60,5
C 35,255,5


      11111111     111111111111111
     110000001     100000000000001
    1100000011     100011100020001
   1100000011      1001  100020001
  1100000011       101   100020001
 1100000011        11   1100020001
110000001111111        11000200011
100000000000001       11000200011
1000S0000000001      11000200011
111111110000001     11000200011 11
       10000001    11000200011 101
       100000011111100000001111101        
       100000000000000000000000001
       111111111111111111111111111
